10 10 1
@ @ @ @ @ @ @ @ @ @
@ @ . C . . . . . @
@ . . @ . @ @ @ . @
@ @ . . @ @ @ @ . @
@ . . . . . . . . @
@ . . @ @ @ @ @ . @
@ @ . @ @ @ @ . . @
@ . . @ . . . . . @
@ @ K . . . . . . @
@ @ @ @ @ @ @ @ @ @
